30 20 10 0 0 0 0 0 0 0 0 0 0 0 0 0 10 10 20 20
30 20 10 10 0 0 0 0 0 0 0 0 0 0 0 0 0 10 20 20
30 30 20 10 0 0 0 0 0 0 0 0 0 0 0 0 0 10 10 20
40 30 20 20 10 0 0 0 0 0 0 0 0 0 0 0 0 10 10 20
40 30 30 20 10 10 0 0 0 0 0 0 0 0 0 0 0 0 10 10
40 40 30 30 20 10 10 0 0 0 0 0 0 0 0 0 0 0 0 10
40 40 40 30 30 20 10 10 0 0 0 0 0 0 0 0 0 0 0 10
50 40 40 30 30 20 20 10 0 0 0 0 0 0 0 0 0 0 0 0
50 40 40 40 30 30 20 10 10 0 0 0 0 0 0 0 0 0 0 10
50 40 40 40 30 30 20 20 10 0 0 0 0 0 0 0 0 10 10 10
50 40 40 40 40 30 20 20 10 0 0 0 0 0 0 0 10 10 20 20
40 40 40 40 30 30 30 20 10 10 0 0 0 0 0 10 20 20 20 30
40 40 40 40 30 30 30 20 10 10 0 0 0 0 10 20 20 30 30 30
40 40 40 30 30 30 30 20 20 10 10 10 10 10 10 20 30 40 40 40
40 30 30 30 30 30 30 20 20 10 10 10 10 10 20 20 30 40 50 50
30 30 30 30 30 30 30 20 20 20 10 10 10 10 20 20 30 40 50 50
30 30 30 30 30 30 30 20 20 20 10 10 10 10 20 20 30 40 40 50
30 30 30 30 30 30 30 20 20 20 10 10 10 10 10 20 20 30 40 40
30 30 30 30 30 30 30 20 20 10 10 10 10 10 10 10 20 20 30 40
20 30 30 30 30 30 30 20 20 10 10 10 0 0 0 10 10 20 20 30
