10 9 20 29 25 10 0 0 0 7 10 6 0 0 0
20 18 23 24 15 0 0 0 1 17 20 15 4 0 0
19 15 18 21 16 4 0 0 17 30 29 20 9 3 5
10 4 8 18 23 16 11 19 33 37 27 15 7 7 12
4 0 0 13 23 20 18 27 36 33 18 2 0 7 15
10 0 0 6 12 10 8 19 29 26 10 0 0 3 13
18 7 1 1 1 0 0 7 20 20 7 0 0 4 14
22 13 7 4 0 0 0 0 11 19 14 8 12 21 26
19 13 13 15 11 1 0 0 0 16 22 27 36 40 36
12 9 16 24 22 10 0 0 0 7 21 34 44 44 34
10 7 15 24 22 10 0 0 0 0 10 23 34 32 19
9 8 14 20 17 6 0 0 0 0 0 7 18 16 4
10 11 14 15 12 7 0 0 0 0 0 0 6 8 0
11 16 15 10 6 10 11 0 0 0 0 0 10 16 4
11 19 16 5 2 11 21 16 2 0 0 7 26 33 21
